11111
100P1
100C1
1N001
1E001
11111
