11111111111111111111111111111111111111111111111
10P00000000000000000000000000000000000000000E01
10CCCCC0CCCCC0CCCCC0CCCCC000CCCCC0C000C0C000C01
10C0000000C000C000C0C000C000C00000C000C0C000C01
10C0000000C000C000C0C000C000C00000C000C0C000C01
10C0000000C000CCCCC0C000C000C00000CCCCC0C000C01
10C0000000C000C000C0C000C000C00000C000C0C000C01
10C0000000C000C000C0C000C000C00000C000C0C000C01
10CCCCC0CCCCC0C000C0CCCCC000CCCCC0C000C0CCCCC01
10000000000000000000000000000000000000000000001
11111111111111111111111111111111111111111111111