111111111111111
1P0000000000001
101111111111101
1000000C0000001
111110111111101
10C000000N00001
101111111111101
1C00000000000E1
111111111111111
