111111
100P01
100C01
1N0001
1E0001
111111