11111111
1P00C0E1
1C0N00C1
10000001
1N00C0N1
11111111